學年度,總在學人數,男生, 男生比例 ,女生,女生比例
101,15204,7927,52%,7277,48%
102,17055,8869,52%,8186,48%
103,20053,10559,53%,9494,47%
104,22830,12036,54%,10794,47%
105,24528,12925,53%,11603,47%
106,25182,13210,52%,11972,48%
107,24451,12618,52%,11833,48%
108,28745,14758,51%,13987,49%
109,30502,15503,51%,14999,49%
110,33489,17060,51%,16429,49%
